novella = новела+
-9тиg = зло+
<м = мой;
<<t = нет+
<< = не+
<<? = незнаю+
? = знаю+
РудеР = разве+
zis = этому+
yn = мир+
yny = миру+
радог = рад)
F^ = фух+
&^ = вух+
&^^^ = вууух+
N^вix(ing) = нравикс(вы)+
N^вix(ing) = sнравикс(вы)+
antizies = ничего+
как = как+
ГоГ = горой+
ГоГ = гарой+
наг = надо+
выгор = вот+
- = же+
Yib = ::
жеja = утро+
[ябле] = [яблоко]+
vv^^xx█-<<ня-caten = хорош+
эгана-<>>>< = зарядка+
godh = боже+
maet = мой+
дыд = да+
Гies = что+
ТаРти데 = спасибо+
데f = нашол([])-([])+
haeih = хех+
haа^h = хах+
crustall = кристал+
z = с+
pomehsu = помошью+
гыл'th = был+
создан = впервые+
впервые = создан+
elamt = елемент+
crystal'y+ = кристлизованя+
crystal'y+ = кристализованя+
crystal'y+ = кристлизованая+
пруд = ртуть+
мат'er = материей+
вселшенной = другой+
другой'th = вселшенной+
t' = его+
Looptig'o = смешаная+
Approet = жить+
MatS = материалам+
учеч = образование+
crystall = кристала+
hightr = сложным+
crystall'ty = кристализованыйs
taytan = титанs
un = вселеннойs
apporeg = помещаютs
mat = матернииs
freshfish = смешиваетсяs
т = кs
ы> = изs
<|||> = вокругs
mat = материюs
глот = поглащаетs
иДЭД = идет+
rjulf = когда+
Apponeng = позваляет+
istverium = иствериум+
istverium'th = иствериума+
haа^h = ха+
фаг = видно+
меня = тебя+
муне = тебе+
кис = первое+
кис = сперва+
кис = первый+
кис = один+
tzn = задание+
hoh = найти+
hoh = найди+
дол = задолбал+
█troй = ...ты+ 
hiden = спрятаное+
доброшит = кто+
юдоgisinтес = фотосинтез+
жодош = зарядка
адидас = пидарас+
gov ertti = поевесть+
it = в+
гд = чтото
гд = чото+
гд = то+
figh = убер+
figh = супер+
figh = гипер+
un = вселенная+
in = и+
долвва = диета+
Yиza = просто+
^^ = это+
Э<n = сложность+
ты = сложность+
sdfjih<>> = новичок+
nix = исходный+
vvvvx = языг+
>><<<><> = язык+
└┐┌┘ = сохранение+
vv-h = сложность+
apm = арена+
█ = ...+
>ве = мило+
giga = очень+
tiges = тигр+
sos = но+
domonic = назойливые+
тота = только+
прв = привет+
<<Might = немогу+
^^V = великий+
<>h = герой+
сесный = сосун+
*|* = процент+
отдроx = отдали+
st = тупо+
iш = если+
шж = шаг+
<>>> = можешь+
mie = умереть+
stopy = соять+
<><>ii = место+
safer = без_опастей+
hs = сылка+
bolk = предотвращение+
generation = главная+
fight = суперсупер+
lisasma = лучшая+
hameл = игра+
vv^^xx█ = красиво+
vv^^xx█-<<ня = магия+
flee-бля = беги+
<<ня = деиствие+
miggh = атака+
АААГОНЬ = пощади+
was = было+
лонот'h = ломать+
бебур = бедрок+
xyz = хуй+
полд-vox = полоблок+
vox = voxel+
полд = половина+
Zies = это+
бегор = чёрный+
strigs = береза+
сратор = светофор+
цракт = цветок+
цац = цветик+
цаца = цветочик+
cucloid = ребёнок+
трастор = комбаин+
фраме> = день+
фракт = ебать+
troй = ты+
агамадар = очень+
tram = хочешь+
bлад = плохо+
xime = time+
трогVV = сегодня+
graat = красиво+
кок = ад+
жратить = закрыть+
жратить'тх = сломать+
шол = базар+
>бля = прёш+
проп = кофе+
ч = чай+
поешёё = пожалуйста+
>>>>< = просрись+
><v^,><v^ = снова+
\\V// = намёк+
grand = стоять+
>g = строка+
<><>> = правее+
<<><> = левее+
карп = гавно+
рыба = гниль+
икра = мёд+
тома = дура+
тупь = пильмень+
тюпь = пялямяня+
пелэд = перец+
гязь = зять+
ёбн = ненадо+
/ = глар+
ыра = спам+
десять = 1-ин+
тристо = 3-не+
миллион = 1-са+
миллиард = 1-ка+
тысеча = 10-не+
триллион = 1-fa+
квадралион = 1-жа+
квинтелион = 1-da+
сикселион = 1-та+
спстелион = 1-сра+
актилион = 1-ак+
кис = 1+
кит = 2+
ким = 3+
кир = 4+
кил = 5+
сикс = 6+
киг = 7+
кин = 8+
ней = 9+
нег = 0+
анти-нег = ∞+
тюпь-нег = -∞+
Ṳ = fat+
value[] = числа+
&>> = я+
lanaчnik = продовец+
<> = с чегото+
de = было+
сool = круто+
но = но+
длеб = вдруг+
породё = продажи+
дуbalи = рухнули+
$ = теро+
ill = в_чтото+
иот = теперь+
live = жызнь+
dramage = драма+
Dirdly = птица+
Smartm = умный+
Smaritm = умно+
Гapa = раса+
Namam = урон+
Nm = *+
[█] = смайлик+
мадагм = вафля+
туДд = туда+
нЩоК = дуэль+
Nies = Найди+
ябле = яблоко+
зози = за+
гого = гора+
дыд = успокойся+
fram = друг+
мя = Ответь+
продент = процент+
медо/ = моё+
hs = имя+
Lёnar = любовь+
FayLёnarfight = боготворю+
Fay = полёт+
nay = знает+
проргено = пророчество+
ми데и = мифи+
ГОНОНИт = гворит+
Гора = только+
киsek = приручение+
kiль = убить+
кеки = живу+
фи = на+
нир = под+
ем = ем+
сатал = слат+
иш = и+
всехнрп = всех+
всят = всё+
всег = все+
торов = всо+
дол = оно+
сор = она+
гот = он+
тебед = они+
дикст = вневебать+
треп = ебу+
гариб'th = яблоком+
нборг = яблоко+
нади = яблоки+
warnt = хочю+
бarnt = хочу+
want = хачю+
tax = хачу+
<><<<<<< = сукаЖ
ДДеb = блять_
<><<<<<<_wowa = блядь_
лепошпра = блин+
wowaи = женщина+
wowa = предатель+
кибинq = киви+
teliь = троль++